20 20
100 100
2 2 2 2 2 2 2 2 2 2 2 2 2 2 2 2 2 2 2 2
2 0 0 0 2 2 0 0 0 11 4 5 0 0 0 0 0 0 0 2
2 0 0 0 0 0 0 0 0 10 3 14 5 1 1 1 1 1 0 2
2 0 0 0 0 0 0 0 0 10 3 3 6 1 2 2 2 1 0 2
2 0 0 0 0 0 0 0 0 9 13 3 14 5 1 2 2 1 0 2
2 0 0 0 0 0 0 0 0 0 10 3 3 6 1 1 2 1 0 2
2 0 0 0 0 0 0 0 0 0 9 13 3 14 5 1 1 1 0 2
2 0 0 0 0 0 0 0 0 0 0 10 3 3 14 5 0 0 0 2
2 0 0 0 0 0 0 0 1 0 1 9 13 3 3 14 4 5 0 2
2 0 0 0 0 0 0 0 0 0 0 0 9 13 3 3 3 14 5 2
2 0 0 0 0 0 1 0 0 2 0 0 1 9 8 13 3 3 6 2
2 0 0 0 0 0 0 1 0 0 0 1 0 0 0 9 8 8 7 2
2 0 0 0 0 0 0 0 1 1 1 0 0 0 0 0 0 0 0 2
2 0 0 0 0 0 0 0 0 0 0 0 0 0 0 0 0 0 0 2
2 0 0 0 1 1 0 0 0 0 0 0 0 0 0 0 0 0 0 2
2 0 0 1 1 1 0 0 0 0 0 0 0 0 0 0 0 0 0 2
2 0 0 1 1 0 0 0 0 0 0 0 0 0 0 0 0 0 0 2
2 0 1 1 1 0 0 0 0 0 0 0 0 0 0 0 0 0 0 2
2 0 0 0 0 0 0 0 0 0 0 0 0 0 0 0 0 0 0 2
2 2 2 2 2 2 2 2 2 2 2 2 2 2 2 2 2 2 2 2
